map (
r(1 1 1 0 0 0 0)
r(1 1 1 0 0 1 1)
r(1 1 1 0 0 1 1)
r(0 0 0 0 0 1 1)
r(0 0 0 1 1 1 1)
r(0 0 0 1 1 0 0)
r(0 0 0 0 0 0 0)
)
